0000000000000000
0000000000000000
0000000000000000
0000000000000000
0000000000000000
0000000000000000
0000000000000000
0000000000000000
0000000000000000
0000000000000000
0000000000000000
2323232023232323

6666666666666666
0000000000001000
0000000000030000
0003000000300000
0300000003000030
0000000030030000
0000000300300000
0000003030000000
0000003000000000
0000000000000000
0000000000000001
0123456789ABCD00

0000000000000000
0000000000000000
0000000000000000
0000000000000000
0000000000000000
0005400000000011
0003200000000011
0000000000000000
0000000000000000
0000000000000000
0000000000000000
0000000000000000









000000000003000003000030000300000300030000003003000000010000000000000000:;0600000000000000000000000000000000000000000000000000000000000000000000000000000000000000000000000000000000000000000000
000000000003000003000030000300000300030000003003000000010000000000000000:;06000000000000000000000000